           WWWWWWWWWWWW
WWWWWWWWW  W   WT     W
W     TCW  W W WW WTW W
W R    TW  W W    W   W
W    W  WWWW WWWWWW WWW
W  W  W      WC   T   W
W   W  TWWWW WWWW   WWWWWWWWWWWWWWWWWWWW
WW W WWW  W  T   T   WW   TC           W
WWWWWWWWW  W  WWW WWW WW T  T TTTTT WT W
           WW     WT  WW TT   T   T W  W
WWWWWWWWWWWWWWWWW WWWWWW  TTTTT T T W TW
W  C T T   W    W W   WWT TTTTT T   W  W
W TWWWWT W WWWWWW WWWWWW  TT    TTTTWT W
W W   W  W                TT T T   TWC W
W   W    WWWWWWWWWWWWWWWWWTTCT   T CWWWW
WWWWWWWWWW             WWWWWWWWWWWWWWWWW