                                    WWWWWWWWW  WWWWWWWWWWWWWWWW
                                    W     TCW  W     T        W
                                    W      TW  W  W  WW  WTW  W
                                    W  R    W  W  W      WTW  W
                                    W       W  W  W      WC   W
                                    W      WWWWW  WWWWW   WWWWW
                                    W  W          WC   T  W
                                    W  WW         WWWWW   W
                                    W   W  TWWWW  WWWWW   WWWWWWWWWWWWWWWWWWWWWW
                                    WW 0W0 WW  W  T   T    W     TC            W
                                    WWWWWWWWW  W  WW  WWW  W  T  TT            W
                                               W      WT   W  T      TTTT  WT  W
                                               WWWWW  WWWWWW  T      T  T  WT  W
                                  WWWWWWWWWWWWWWWWWW  WWWWWW  TTTTT  T  T  W   W
                                  W  C T T    W    W  W    WT  TTTTT T     W  TW
                                  W  W T T    W    W  W    W               W  TW
                                  W  TWWWWTW  WWWWWW  WWWWWW  T       TTTTWT   W
                                  W  W     W                  T         CTW T  W
                                  W  W     W                  T  T    TTTTWC   W
                                  W     W     WWWWWWWWWWWWWWWWT  T  TTT  TWWWWWW
                                  W     W     W              WC  T       CW
                                  WWWWWWWWWWWWW              WWWWWWWWWWWWWW