WWWWWWWW
W000000W
W000000W
W000000W
W000000W
W000000W
WWW00WWW