                                                            WWwwwwwwwwWW
                                                            Ww        wW
                    WwwwwwwwwwwwwwwwW    WwwwwwwwwwwW       WC CCCCCC CW
                    W               wwwwwwPP   P    W       WC        CW
                    W PPPP PPPPPPPP      T   P   P  W       WC        CW
Wwwwwwwwwwwwwwwwwwwww PPPP P   PPPP   T     PPPPPP  W       WWCC    CCWW
W                     PPPP PCP PPPP WwwwWT CW       W       wwwwW  WwwwW
W WwwwwwwwwwwwwwwwwwW PPPP PPP PPPP W   wwwwW  Wwwwww           W  W
W W                 W PPPP     PPPP W       WT W                W  W
W W                 W PPPPPPPPPPPPP W       W  W                W  W
W W                 W               W       W TW        WwwwwwwwW  wwwwwwwwW
W W                 wwwwwwW  Wwwwwwww       W  W        W      TT  P   P   W
W W      WwwwW            W TW          Wwwww  wwwwW    W wwWw PW    T     W
W W      W   W     Wwwwwwww  wwWwwwwW   WP        PW    W   W  WwwwWwwwwww W
W wwwwwwww CCW     W           w   Pwwwww          wwwwwwww W ww   W   T   W
W T          W     W wWwwwWwTW   W           R              W    WTW T   TWW
W WwwwwwwWCCCW     W  W   w CW   W                          W W W    wwwwwwW
W W      wwwww     Ww W W   PW   W  WwwwW  0    0  WwwwwWww w w wC        PW
W W                W  W wWwTWwTW    W   WP        PW    W       TTwwWwwwW  W
W W                W wW  w CWP W wwwW   wwwwW  Wwwww    W T wwwww   W   wT W
W W                W Pww   www W    W       W  W        W         W   W    W
W W                W    W W    wwww W       W  W        wwwwwwwwwwwwwwwwwwwW
W wwwwwwwwwwwwwwwwww ww w w ww      W       W  W
W                     T        TPPTCW       W  W
wwwwwwwwwwwwwwwwwwwwwwwwwwwwwwwwwwwww       W  W
                                            W  W
                                            W  W
                                            W  W
                        Wwwwwwwwwwwwwwwwwwwww  wwwwwwwwwwwwwwwwwwwwW
                        W                                          W
                        W                                          W
                        W  T T  TTT  T T  T T  TTT  TTT  T T  TTT  W
                        W   CT       TwT  T T    T  TP   TCT  T T  W
                        W  T T  TTT  T T  TTT  TTT  TTT  TTT  TTT  W
                        W                                          W
                        W                                          W
                        W  TTT  T T  TTT  TTT  T T  TTT  TTT  TTT  W
                        W  Tw    C   T T  TTT  TP   T T  T T  T T  W
                        W  T T  TTT  TTT  TTT  TTT  TTT  TTT  TTT  W
                        W                                          W
                        W                                          W
                        W  TTT  T T  TTT  TTT  T T  TTT  T T  T T  W
                        W  T T   CT  TPT  TTT  TwT  T T       TCT  W
                        W  TTT  T T  T T  TTT  TTT  TTT  T T  T T  W
                        W                                          W
                        W                                          W
                        Wwwwwwwwwwwwwwwwwwwwwwwwwwwwwwwwwwwwwwwwwwww