WWWWWWWW
WR   TCW
W     TW
W      W
W      W
W      W
WWW  WWW
WWWWWWWW
