WWWWWWWW
WR   TCW
W     TW
W      W
W      W
W      W
WWW00WWW
WWWWWWWW
